rules=правила;
document=документ;
intro=Введение;
conclusion=Заключение;
literature=Список литературы;
chapter=Глава;
appendices=Приложения;
listOfTermsAndAbbreviations=Список терминов и аббревиатур;
validateAbbreviation=проверить аббревиатуры;
validateKeyWords=проверить по ключевым словам;
getCommonKeyWords=получить общие ключевые слова;
getKeyWords=получить ключевые слова;
keywordIntersection=проверить пересечение КС;
keyWords=ключевые слова;
title=заголовок;
subsectionQuantity=количество подразделов;
generalRules=общие правила;
words=слова;
wordsInclusion=раздел содержит слова;
titleContains=заголовок содержит;
keySensitive=чувствительность к регистру;
lastSubsectionTitle=заголовок последнего подраздела содержит;
minSubsectionQuantity=минимальное количество подразделов;
maxSubsectionQuantity=максимальное количество подразделов;
generalInformation=Общие сведения;
appointmentAndPurposes=Назначение и цели создания (развития) системы;
objectsAutomationCharacteristics=Характеристика объектов автоматизации;
systemRequirements=Требования к системе;
worksCompositionAndContent=Состав и содержание работ по созданию системы;
systemControlAndAcceptance=Порядок контроля и приемки системы;
requirementsEnterSystem=Требования к составу и содержанию работ по подготовке объекта автоматизации к вводу системы в действие;
documentationRequirements=Требования к документированию;
developmentSources=Источники разработки;
appendices=Приложения;
purposeAndConditionsOfUse=Назначение и условия применения;
preparationForWork=Подготовка к работе;
operationDescription=Описание операций;
emergencySituations=Аварийные ситуации;
developmentRecommendations=Рекомендации к освоению;